8, 9, 9, 9, 9, 9, 9, 9, 9, 6
9, 5, 3, 7, 6, 3, 9, 9, 8, 9
3, 7, 9, 7, 5, 1, 4, 6, 9, 9
5, 8, 3, 8, 5, 1, 7, 4, 8, 7
1, 5, 8, 3, 3, 8, 2, 6, 3, 9
8, 5, 1, 3, 5, 9, 1, 5, 7, 5
8, 5, 9, 6, 6, 5, 6, 4, 6, 3
2, 2, 6, 6, 5, 1, 7, 8, 9, 8
9, 9, 5, 4, 7, 3, 8, 8, 9, 6
9, 6, 5, 6, 9, 9, 8, 1, 6, 5
